NO ./image/path_to_the_north_texture.xpm

SO ./image/path_to_the_south_texture.xpm

WE ./image/path_to_the_west_texture.xpm

EA  ./image/path_to_the_east_texture.xpm

F    25,25,10
C     25,205,25


1111111111111111111111111111111111111111111111
111111111111111111111111111111111111111111
11111111000000000000000000000001111111
1000000000000000001111000000000011111111111111
11000000000000000011000000000000111000000001
11111011111111111111111111011111111111111101
1000101111111111111111111111100011111111111111011111
110000000000000111100000000000000000001100001
1000000000000000000000000000000000000011100011 
1100000000000001111000000000001111100011000001
100000000W0000011000000000001100011000001
11111111111111111111111111111111111111111111111111111111111111111111111111111111111111111111
11111111111111111111111111111111111111111111111111111111111111111111111111111111111111111111
1110000000000001111111100000000000110001110000111
1111000000000000001000000000000001100011110000001
1100000000000000000000000001111111111111000011111
1111100000110000000000000000000110001    
111000000000000000000000000001111111111111111110001  
111111000000000000000000000000000000000000000000001   
11111100000000000000000011111111111111111000001    
1111110000000000111111111111111   
11111111001111111111                       
11111                               
1111111111111111111111111111111111111111111111