NO ./image/path_to_the_north_texture.xpm

SO ./image/path_to_the_south_texture.xpm

WE ./image/path_to_the_west_texture.xpm

EA  ./image/path_to_the_east_texture.xpm

F    255,255,0
C     255,25,255


1111111111111111111111111111111111111111111111
111111111111111111111111111111111111111111
 111111110000000000000000000000011    11111
 10000000000000000011110000000000111   11111111111
 1100000000000000001  10000000000001   11000000001
 1111111111111111111  11111110111111   11111111101
                           10001               101
 11111111111111111     111110001111111111111   1011111
 11000000000000011    1100000000000000000001   100001
 10000000000000001    1000000000000000000001   1100011 
 11000000000000011    1100000000000111110001   1000001
 1000000000000001      1000000000001   10001   1000001
 11100000000000011111111000000000001   10001   11000011
  1111000000000000001000000000000001   10001  1110000001
  1100000000000000000000000001111111   11111  1000111111
  11111000001100000000000000000001            10001    
1110000000000000N0000000000001111111111111111110001  
111111000000000000000000000000000000000000000000001   
    11111100000000000000000011111111111111111000001    
        1111110000000000111111            111111111   
            11111111001111111111                       
                  11111                               