NO ./image/path_to_the_north_texture.xpm

SO ./image/path_to_the_south_texture.xpm

WE ./image/path_to_the_west_texture.xpm

EA  ./image/path_to_the_east_texture.xpm

F    255,255,0
C     255,25,255

1111111111111111111111111
10000000000000000000000010100001
1000000000000000000000001
1000000000000010000000001
1000000000000000000000001
10000000000111010000000011111111
100000N000010001000000000000001
1000000000010101000000000000001
1000000000000000000000001111111
1000000000000010000000001
1000000000000000000011011
111111111111  11111111111