NO ./image/path_to_the_north_texture.xpm

SO ./image/path_to_the_south_texture.xpm

WE ./image/path_to_the_west_texture.xpm

EA 4 ./image/path_to_the_east_texture.xpm

F    255,255,0
C     255,25,255


111111111111111111111111111
100000000000000000000000001
100000000000000000000000001
100000000000001000000000001
100000000000000000000000001
100000000000000100000000001
1000000N0001111000000000001
100000000000100100000000001
100000000000000000000000001
100000000000001000000000001
100000000000000000000000001
111111111111111111111111111