NO ./image/path_to_the_north_texture.xpm

SO ./image/path_to_the_south_texture.xpm

WE ./image/path_to_the_west_texture.xpm

EA  ./image/path_to_the_east_texture.xpm

F    22,20,100
C     25,205,250

1111111111111111111111111
1000000000000000000000001
10000000111100000000000001
1000000000000010000000001
100000000000000000000001
1010000000000100000000111111111111
1010000N000000100000000000000001
1010000000000100000000000011111111
10000000000000000001111111
100000111110000000010000000001
1000000000000000000011011
1111111111111111111111111