NO ./image/path_to_the_north_texture.xpm

SO ./image/path_to_the_south_texture.xpm

WE ./image/path_to_the_west_texture.xpm

EA  ./image/path_to_the_east_texture.xpm

F    25,25,10
C     25,205,25


111111111111111111111111111111111
111111111111111111111111111111111
111111110000000000000000000000011
100000000000000000111100000000001
110000000000000000110000000000001
111110111111111111111111110111111
100010111111111111111111111110001
110000000000000000000001111000001
100000000000000000000000000000001
110000000000000000000000000000011
100000000W00000000000000000001101
111000000000000000000000000000001
111000000000000000111000000111111
111000000000000000000000110001111
111100000001111111000000010000001
110000000000000000000000000111111
111110000011000000000000000000011
111000000000000000000000000001111
111111000000000000000000000000001
111111000000000000000000000000011
111111000000000011111111111111111
111111111111111111111           1
11111                           1
111111111111111111111111111111111