    NO      ./image/path_to_the_north_texture.xpm
EA  ./image/path_to_the_east_texture.xpm


WE ./image/path_to_the_west_texture.xpm

SO    ./image/path_to_the_south_texture.xpm
C 25,25,255
F        1,22,15

1                                                        111111111111111111111111111111111111111111111111111
1                                                 111111100100100010100000000000000000000000000000000000011
1111111111111111111111111111111111111111         10000000000000000010000000000000000000000000000011111111
111111110000000000000000000000011    11111        11111110000000000000000000000000000000000000000000000011
 10000000000000000011110000000000111   11111111111     100000000000000000000000000000000000000000000000011
 1100000000000000001  10000000000001   11000000001     10000000000000000000000000000000000000000000000000011
 1111111111111111111  11111110111111   11111111101     100000000000000000000000000000000000000000000000000011
                           10001               101     100000000000000000000000001000000000000000000000000011
11111111111111111     111110001111111111111   101111  1000000000000000000000000111000000000000000000000000011
 11000000000000011    1100000000000000000001   100001  10000000000000000000000011 11000000000000000000000000011
 10000000000000001    1000000000000000000001   1100011 100000000000000000000011  11000000000000000000000000011
11000000000000011    1100000000000111110001   1000001 10000000000000000000000011 11000000000000000000000000011
11000000000000001      1000000000001   10001   1000001 1000000000000000000000000111000000000000000000000000011
111000000000000111111111000000000001   10001   110000111000000000S00000000000000001000000000000000000000000011
  1111000000000000001000000000000001   10001  111000000000000000000000000000000000000000000000000000000000111
  1100000000000000000000000001111111   11111  100011111100000000000000100000000000000000000000000000000000011
  11111000001100000000000000000001            10001    10000000000000101000000000000000000000000000000000011
111000000000000000000000000001111111111111111110001    1000000000000001000000000000000000000000000000011111
111111000000000000000000000000000000000000000000001    1000000000000000000000000000000000000000000000011
    11111100000000000000000011111111111111111000001    10000000000000000000000000000000000000000000011
        1111110000000000111111            111111111    100000000000000000000000000000000000000000000001111111111
            11111111001111111111                       100000000000000000000000000000000000000000000011
                  110011                               11111111111111111111111111111111111111111111111
                  110011                     11111111111
                  110011                     10000000001
                  110011                     10011110001
                  110011                     1001  10001
             1111111001111111111 1111111111111100111100011111111111111111111111111
             10000000000000000001000000000000000000000000000000000000000011
             10000000000000000000011111111111111111000000000000000000000011
             1111100000000000000001               1000000000000000000000011
                 100000000000000001               1000000111111111111111111
    111111111111110001111111111111111111111111111110000011
    110000000000000000000000000000000000000000000000000011       11111111111111111
    110000000000000000000000000000000000000000000000000011       10000000000000001
    110000000000000000000000000000000000000000000000000011111111110000000000000001
    110000000000000000000000000000000000000000000000000000000000000000000000000001
    110000000000000000000000000000000000000000000000000000000000000000000000000001
    110000000000000000000000000000000000000000000000000011111111110000000000000001
    110000000000000000000000000000000000000000000000000011       1000000000000000111111111
    110000000000000000000000000000000000000000000000000011       1000000000000000000000001
    110000000000000000000000000000000000000000000000000011   11111000000000000000000000001
    110000000000000000000000000000000000000000000000000011   10000000000000000000000000001
    110000000000000000000000000000000000000000000000000011   10000000000000000000000000001
    110000000000000001000000000000000000000000000000000011   11111111111111111111111111111
111111111111111111111111111111111111111111111111111111111