    NO      ./image/path_to_the_north_texture.xpm
EA  ./image/path_to_the_east_texture.xpm


WE ./image/path_to_the_west_texture.xpm

SO    ./image/path_to_the_south_texture.xpm
C 25,25,255
F        1,22,15
    111111111111111111111111111111111111111111111111111111111
    111111111111110001111111111111111111111111111110000011
    110000000000000000000000000000000000000000000000000011       11111111111111111
    110000000000000000000000000000000000001100000000000011       10000000000000001
    110000000000000000010011111100000000001100000000000011111111110000000000000001
    110000111000000000000001111000000000001100000000000000000000000000000000000001
    11000000000000000000N000000000000000000000000000000000000000000000000000000001
    110000001110000000000000111000000000111110000000000011111111110000000000000001
    1100000011100000000000001110000000000000000000000000011       1000000000000000111111111
    110000000000000000000000000000000000000000000000000011       1000000000000000000000001
    1100000000000011110000000011000000000011000000000000011   11111000000000000000000000001
    1100000000000000000000000011000000000011000000000000011   10000000000000000000000000001
    1100000000000000000000000011000000000011000000000000011   10000000000000000000000000001
    110000000000000001000000000000000000000000000000000011   11111111111111111111111111111
111111111111111111111111111111111111111111111111111111111